                                     
       --#--           A         #   
    A                 ###       ##   
 --###---                ###        A
          ##                       ##
   ###            ###                
                              ##     
  A     #####   A A                  
  ###         -#####---   ##         
                                ###	 
#      1 2               A A         
    ####### A A A       ##########   
#####################################
