                                     
       --#--           A         #   
    A                 ###       ##   
 --###---  1             ###        A
          ##    2                  ##
   ###         ###                   
         A A                  ##     
  A     #####   A A                  
  ###         -#####---   ##         
                                ###	 
#                        A A         
    #######   A A       ##########   
#####################################
