                                     
       --#--           B         #   
    A                 ###       ##   
 --###---  1             ###        A
          ##    2                  ##
   ###         ###                   
         A A                  ##     
  A     #####   A A                  
  ###         -#####---   ##         
                                ###	 
#    B                   A A         
    #######   A B       ##########   
#####################################
